Level, expNext, hp+, mp+, att+, def+, acc+
1, 8, 2, 1, 1, 1, 1, 18
2, 18, 3, 1, 1, 1, 1, 30
3, 30, 4, 1, 1, 1, 1, 50
4, 50, 5, 1, 1, 1, 1, 80
5, 80, 6, 1, 1, 1, 1, 130
6, 130, 7, 1, 1, 1, 1, 210
7, 210, 8, 1, 1, 1, 1, 340
8, 340, 9, 1, 1, 1, 1, 550
9, 550, 10, 1, 1, 1, 1, 890
10, 890, 11, 1, 1, 1, 1, 1440
11, 1440, 12, 1, 1, 1, 1, 2330
12, 2330, 13, 1, 1, 1, 1, 3770
13, 3770, 14, 1, 1, 1, 1, 6000
14, 6000, 15, 1, 1, 1, 1, 6000